Medium map
VVVVVVVVVVVVVVVVVVVVVVVVVVVVVVVVVVVVVVVVVVVVVVVVVVVV
VVDDDDDD---VVVVVVVVVVVVVVVVVVVVVVVVVVVVVVVVVVVVVVVVV
VDDWWWDDDD--VVVVVVVVVVVVVVVVVVVVVVVVVVVVVVVVVVVVVVVV
VDWWWWWDDDD--VVVDDDDDDDDVVVVVVVVVVVVVVVVVDDDDDDVVVVV
VDWWGWWDDDD----VDDDWWWWWDDDVVVVVVVVVVVVDDDDDDDDDDDVV
VDDDDDDDDDD---DDDDWWWWWWWDDDVVVVVVVVVVDDDDDDDDDDDDVV
V-DDDDDDDDD--DDDDDWWWGWWWDDDDVVVVVVVVDDDDDDDDDDDDDDV
V---DDDDD----DDDDDWW---WWDDDDVVVVVVVDDDDDWWWWWDDDDDV
V----DDD----VVVDDD-------DDDDVVVVVVDDDDDWWWWWWWDDDDV
VVV-------VVVVVDDDD-----DDDDDVVVVVDDDDWDWWWWWWWDWDVV
VVVVVVVVVVVVVVVVDDDD-----DDDDVVVVVDDDDWDWWWGWWWDWDVV
VVVVVVVVVVVVVVVVVVWW------WWVVVVVVDDDDDDDD---DDDDVVV
VVVVVVVVVVVVVVVVVVVWW----WWVVVVVVVVDDDDDDDD--DDDDVVV
VVVVVVVVVVVVVVVVVVVWW----WWVVVVVVVVDDDDDDDD--DDDDVVV
VVVVVVVVVVVVVVVVVVVWW---------------DDDDDD---DDDDDVV
VVVVVVVVVVVVVVVVVVVWW---------------DDDDDD---DDDDDDV
VVVVVVVVVVVVDDDDVVVWW----WWVVVVVVVVVDDDDDD--DDDDDDDV
VVVVVVVVVVVDDDWDDDWW------WWVVVVVVVVDDDDDD--DDDDDDDV
VVVVVVVVVVVDDWWWDDW--------WVVVVVVVVDDDDDD--DDDDDDDV
VVVVVVVVVVVDDWGWDDW--W--W--WVVVVVVVVDDDDDD--DDDDDDVV
VVVVVVVVVVDDD---------WW---WVVVVVVVVDDDDDD--DDDDDDVV
VVVVVVVVVVDDDD-------W--W--WVVVVVVVDDDDDDD--DDDDDVVV
VVVVVVVVVVVDDDDDDDWW------WWVVVVVVVDDDDDDD--DDDDDVVV
VVVVVVVVVVVVDDDDDDDWWWWWWWWVVVVVVVVVDDDDDD--DDDDDVVV
VVVVVVVVVVVVVVVDDDDVVVVVVVVVVVVVVVVVVDDDDD--DDDDDVVV
VVVVVVVVVVVVVVVVVVVVVVVVVVVVVVVVVVVVVDDDD---DDDDDVVV
VVVVVVVVVVVVVVVVVVVVVVVVVVVVVVVVVVVVVDDDD---DDDDDVVV
VVVVVVVVVVVVVVVVVVVVVVVVVVVVVVVVVVVVVDDDD--DDDDDDDVV
VVVVVVVVVVVVVVVVVVVVVVVVVVVVVVVVVVVVVDDDD--DDDDDDDDV
VVVVVVVVVVVVVVVVVVVVVVVVVVVVVVVVVVVVVDDDD--DDDDDDDDV
VVVVVVVVDDDVVVVVVVVVVVVVVDDDDDDDVVVVDDDDD--DDDDDDDDV
VVVVDDDDDDDDDDDVVVVVVVVVDDDDDDDDDDDDDDDDD--DDDDDDDDV
VVVDDDD-------DDDVVVVVVDDDDWWWDDDDDDDDDDD--DDDDDDDDV
VVDDD--DDD-DDD--DDVVVVDDDDWWWWDDDDDDDDDD----DDDDDDDV
VVDD-WDDWWWWWDDW-DDVVVDDDWWWGWDDDDDDDDD------DDDDDDV
VVDD-DDW-D-D-WDD-DDDVDDDDD-------------------D-D-DDV
VDD-DDW-DDDDD-WDD-DDVDDDDDD--------------------DDD-V
VDD-DW-DW---WD-WD-DDDVVVVVDDDDDDDDDDDDD------DDDDDDV
VDD-DWDD-D-D-DDWD-DDDVVVVVVVVDDDDDDDDDDD----DDDDDDVV
VDD--W-D--D--D-W--DDDVVVVVVVVVVDDDDDDDDDD-DDDDDDDVVV
VVD-DWDD-D-D-DDWD-DDDDDDDDDDDDDDVVVVDDDDD--DDDDDVVVV
VVD-DW-DW---WD-WD-DDDDVVVVVVVVVVVVVVVDDDD-DDDDDDVVVV
VVD-DDW-DD-DD-WDD-DDDDVVVVVVVVWVVVVVVVDDDDD-DDDVVVVV
VVDD-DDW-D-D-WDD-DDDDDDVVVVVVWWWVVVVVVDDDD-DDDDVVVVV
VVDD-WDDWW-WWDDW-DDDDDDDVVVVDWGWVVVVVVVDDDDDDDDVVVVV
VVDDD--DDD-DDD--DDDDDDDDDDDDDDDDDVVVVVVDD-DDDDVVVVVV
VVDDDDD-------DDDDDDDDDDDDDDDDDDDDVVVVVVDDDDVVVVVVVV
VVVDDDDDDDDDDDDDDDDDDVVVVDDDDDDDDDVVVVVVVVVVVVVVVVVV
VVVVVDDDDDDDDDDDDDDVVVVVVVVVDDDDDVVVVVVVVVVVVVVVVVVV
VVVVVVVVVVVVDDDDDVVVVVVVVVVVVVVVVVVVVVVVVVVVVVVVVVVV
VVVVVVVVVVVVVVVVVVVVVVVVVVVVVVVVVVVVVVVVVVVVVVVVVVVV
END POSITION
10
39
STARTING POSITION
416
352
672
352
544
352
DUNGEON DOORS
4
4
14
19
21
6
43
10
28
34
30
44
